XXXXXXXXXXXXXX-XXXXXXXXXXXX-XXXX
Xp--------XXXX------------X---pX
X-XXXXXX-XXXXXX-XXXXXXXXX-XXXX-X
X----------X-------X------X----X
X-XXXXXX-X-X-XXXXXXX-XXXXXXX-XXX
--XP-----X-X--------------------
X-X-XXXX-X---XX-XX-X-XXXX-XXXXXX
X-X------X-X-XX-XXpX---XX----X-X
X-XXXXXX-X-X-XXXXX-X-X---XXX-X-X
X--------X-X-X---X---X-X-XXX---X
X-XX-XXXXX-X-X-X-X-X-X-X-XXX-X-X
--XX-----X--------X---X---------
X-XXXXXX-XX-XxxxX-XX-XXXXXXX-X-X
X-----XX----XG_GX-X---------X--X
X-XXX-XXXX-XX_G_X-XX-XXXX-XXXX-X
X-X---------XG_GX-X---X---X----X
X-X-XXX-XXX-XXXXX---X-XXX-X-XX-X
X-X-X-X---------X-XXX---X-X-XX-X
X---X---XXXXXXX---XXXXX-X---XX-X
X-X-X-X------X--X---------X-XX-X
X---X---XXXX-X----XXXXXXX-X-X--X
--XXXX---------XXXXXXXXXX---XX--
Xp-----X-X-X-X----XXXXXXX-X---pX
XXXXXXXXXXXXXX-XXXXXXXXXXXX-XXXX