XXXXX-XXXXXXXXXXXXX-XXXXXXXXXX-X
X-----------------X----------X-X
X-XXXXXXXXXXXXXXX-X-XXXXXXXX-X-X
X-XXXp----------X-X-X----pXX-X-X
X-X---XXXXXXX-XXX-X-X-XXX-XX-X-X
X-XX-XX-------X---X-------XX---X
X--X--XXX-XXXXX-XXXXXXXXX--X-X-X
XX--X--XX----X--X-X----XXX-X-X-X
--X--X-XX-XX-X-XX-X-XX-----X-X--
X-----------------X-XXXXXXXX-X-X
X-XXXXXXXX-XXXXXX--p---------X-X
X-XXXXX-----------XXXXXXXXXXXX-X
X-------XX--XxxxX--------------X
X-XXXX-XXX-XXG_GX-X-XX-X-X-XXX-X
---------X--X_G_X-X----X-X-XXX--
XXXXXXXX-XX-XG_GX-XXXXXX-X-XXX-X
X-----------XXXXX--------X-----X
X-XXXXX-XXX---P---XXXXXX-XXXXX-X
X---XXX--XX-X-XXX-----XX----pX-X
--XpXXXX--X-X-XXXX-XX--XXX-XXX--
X-------X--XX-------XX---X-----X
X-XXXXX-XX-XXXXXX-X----X-XX-XX-X
X--------------------XXX-------X
XXXXX-XXXXXXXXXXXXXX-XXXXXXXXX-X