XXXXXXXXXXXXXXX-XXXXXXXXXXXXXXXX
X------------------------------X
X-XXXXXXX-XXXXXXXXXXXXXX-XXXXXpX
X-XXXXXXX-XXXXXXXXXXXXXX-XXXXXXX
--------------P-----------------
X-XXXXXXXXXXXXXXXXXXXX-XXXXXXXXX
X-----------------------------pX
X-XXXXXX-XXXXXXXX-XXXXXXXXXXXXXX
--------------------------------
X-XXXXXXXXXXXX-XXXXXXX-XXXXXXX-X
X------------------------------X
X-XXXpXXXXX-------XXX-XXXXXXXX-X
X-XXX-XXXXX-XxxxX--------------X
X-----------XG_GX-XXXXXXXX-XXX-X
X-XXXXX-XXX-X_G_X--------------X
X-----------XG_GX-XX-XXXXXXXXXpX
X-XX-XXXXXX-XXXXX-XX-XXXXXXXXX-X
--------------------------------
XXXXXXX-XXXXXXX-XXXXXX-XXXXXXXXX
X------------------------------X
X-XXXXXXXX-XXXXXXXXXXXXXX-XXXX-X
X-XXXXXXXXpXXXXXXXXXXXXXX-XXXX-X
X------------------------------X
XXXXXXXXXXXXXXX-XXXXXXXXXXXXXXXX